TimeWindow, Flight, SELECTEE, UNKNOWN, LOWRISK1, LOWRISK2, LOWRISK3, LOWRISK4, TOTAL
240, Flight1, 2, 109, 31, 10, 6, 5, 163
240, Flight2, 7, 116, 36, 19, 6, 9, 193
240, Flight3, 3, 133, 30, 22, 9, 9, 206
240, Flight4, 9, 58, 32, 10, 8, 9, 126
240, Flight5, 8, 139, 46, 16, 6, 7, 222
240, Flight6, 6, 94, 32, 22, 4, 3, 161
240, Flight7, 4, 124, 34, 10, 9, 7, 188
240, Flight8, 9, 97, 49, 8, 1, 9, 173
240, Flight9, 5, 71, 47, 24, 7, 7, 161
240, Flight10, 6, 111, 48, 19, 5, 9, 198
240, Flight11, 7, 147, 25, 9, 5, 3, 196
240, Flight12, 6, 99, 45, 21, 5, 3, 179
240, Flight13, 4, 54, 42, 10, 2, 8, 120
240, Flight14, 7, 130, 43, 21, 6, 1, 208
240, Flight15, 4, 50, 45, 9, 1, 7, 116
240, Flight16, 9, 58, 42, 23, 9, 3, 144
240, Flight17, 3, 146, 47, 24, 4, 1, 225
240, Flight18, 5, 65, 45, 22, 1, 9, 147
240, Flight19, 5, 118, 45, 21, 2, 1, 192
240, Flight20, 2, 130, 45, 8, 2, 5, 192
240, Flight21, 7, 137, 35, 18, 9, 5, 211
240, Flight22, 8, 62, 30, 12, 8, 3, 123
240, Flight23, 7, 99, 46, 10, 7, 1, 170
240, Flight24, 3, 73, 32, 9, 8, 4, 129
240, Flight25, 8, 143, 30, 24, 4, 9, 218
240, Flight26, 5, 104, 30, 9, 8, 3, 159
240, Flight27, 8, 61, 46, 9, 8, 5, 137
240, Flight28, 1, 129, 49, 20, 4, 5, 208
240, Flight29, 8, 86, 37, 13, 3, 5, 152
240, Flight30, 2, 74, 25, 8, 3, 9, 121
240, Flight31, 8, 70, 41, 15, 1, 3, 138
240, Flight32, 8, 106, 29, 19, 6, 6, 174
240, Flight33, 1, 77, 34, 19, 7, 4, 142
240, Flight34, 1, 130, 41, 9, 7, 1, 189
240, Flight35, 8, 99, 30, 6, 6, 6, 155
240, Flight36, 5, 60, 35, 24, 2, 3, 129
240, Flight37, 5, 110, 31, 12, 5, 8, 171
240, Flight38, 9, 97, 34, 6, 4, 7, 157
240, Flight39, 1, 129, 42, 5, 1, 8, 186
240, Flight40, 4, 71, 43, 19, 7, 8, 152
240, Flight41, 5, 117, 27, 17, 7, 9, 182
240, Flight42, 1, 148, 49, 6, 2, 3, 209
240, Flight43, 2, 113, 36, 18, 2, 2, 173
240, Flight44, 1, 79, 27, 8, 8, 7, 130
240, Flight45, 5, 78, 36, 6, 9, 6, 140
240, Flight46, 8, 65, 24, 14, 4, 3, 118
240, Flight47, 4, 109, 25, 24, 1, 9, 172
240, Flight48, 8, 109, 24, 22, 9, 4, 176
240, Flight49, 8, 104, 35, 23, 7, 1, 178
240, Flight50, 4, 57, 42, 19, 7, 7, 136
240, Flight51, 1, 130, 42, 21, 9, 1, 204
240, Flight52, 4, 59, 41, 12, 3, 8, 127
240, Flight53, 2, 133, 26, 22, 8, 8, 199
240, Flight54, 6, 128, 32, 11, 4, 2, 183
240, Flight55, 2, 84, 35, 18, 3, 6, 148
240, Flight56, 6, 54, 35, 5, 3, 5, 108
240, Flight57, 1, 93, 49, 19, 8, 7, 177
240, Flight58, 8, 72, 42, 10, 1, 3, 136
240, Flight59, 8, 97, 41, 21, 2, 3, 172
240, Flight60, 1, 137, 44, 11, 6, 3, 202
240, Flight61, 1, 9, 7, 4, 1, 0, 22
240, Flight62, 3, 84, 34, 7, 3, 6, 137
240, Flight63, 4, 93, 16, 3, 5, 1, 122
240, Flight64, 0, 11, 8, 5, 1, 2, 27
240, Flight65, 3, 54, 12, 4, 0, 2, 75
240, Flight66, 2, 35, 12, 3, 2, 2, 56
240, Flight67, 0, 10, 8, 2, 1, 1, 22
240, Flight68, 1, 61, 17, 4, 3, 1, 87
240, Flight69, 6, 92, 24, 12, 4, 6, 144
240, Flight70, 2, 53, 24, 3, 2, 4, 88
240, Flight71, 3, 34, 12, 3, 1, 2, 55
240, Flight72, 1, 10, 5, 4, 2, 1, 23
240, Flight73, 3, 71, 41, 6, 4, 6, 131
240, Flight74, 1, 73, 16, 3, 4, 4, 101
240, Flight75, 4, 43, 27, 9, 1, 4, 88
240, Flight76, 1, 15, 8, 1, 0, 2, 27
240, Flight77, 3, 94, 22, 7, 6, 3, 135
240, Flight78, 5, 68, 25, 5, 1, 1, 105
240, Flight79, 6, 81, 36, 6, 3, 5, 137
240, Flight80, 2, 38, 13, 8, 0, 2, 63
240, Flight81, 2, 29, 8, 3, 2, 0, 44
240, Flight82, 3, 41, 21, 8, 1, 3, 77
240, Flight83, 5, 59, 25, 15, 5, 4, 113
240, Flight84, 6, 56, 26, 8, 6, 5, 107
240, Flight85, 2, 73, 19, 9, 3, 4, 110
240, Flight86, 0, 47, 16, 6, 1, 1, 71
240, Flight87, 0, 25, 9, 7, 2, 2, 45
240, Flight88, 1, 48, 15, 3, 2, 3, 72
240, Flight89, 2, 39, 11, 3, 4, 1, 60
240, Flight90, 3, 39, 10, 2, 0, 1, 55
300, Flight31, 1, 12, 7, 3, 0, 0, 23
300, Flight32, 1, 16, 4, 3, 1, 1, 26
300, Flight33, 0, 5, 2, 1, 1, 0, 9
300, Flight34, 0, 17, 5, 1, 1, 0, 24
300, Flight35, 1, 18, 5, 1, 1, 1, 27
300, Flight36, 0, 1, 1, 0, 0, 0, 2
300, Flight37, 1, 11, 3, 1, 1, 1, 18
300, Flight39, 0, 3, 1, 0, 0, 0, 4
300, Flight40, 0, 5, 3, 1, 1, 1, 11
300, Flight42, 0, 1, 0, 0, 0, 0, 1
300, Flight43, 0, 6, 2, 1, 0, 0, 9
300, Flight45, 0, 4, 2, 0, 0, 0, 6
300, Flight46, 1, 5, 2, 1, 0, 0, 9
300, Flight48, 0, 6, 1, 1, 0, 0, 8
300, Flight49, 0, 1, 0, 0, 0, 0, 1
300, Flight50, 1, 10, 7, 3, 1, 1, 23
300, Flight52, 0, 6, 4, 1, 0, 1, 12
300, Flight53, 0, 14, 3, 2, 1, 1, 21
300, Flight54, 0, 11, 3, 1, 0, 0, 15
300, Flight55, 0, 1, 0, 0, 0, 0, 1
300, Flight56, 1, 8, 5, 1, 0, 1, 16
300, Flight58, 0, 3, 2, 0, 0, 0, 5
300, Flight59, 0, 6, 2, 1, 0, 0, 9
300, Flight61, 4, 36, 25, 14, 6, 2, 87
300, Flight62, 1, 17, 7, 1, 0, 0, 26
300, Flight63, 2, 48, 9, 2, 2, 1, 64
300, Flight64, 1, 41, 31, 16, 4, 6, 99
300, Flight65, 5, 75, 16, 8, 1, 2, 107
300, Flight66, 7, 77, 26, 8, 3, 7, 128
300, Flight67, 1, 42, 32, 10, 5, 2, 92
300, Flight68, 0, 43, 12, 3, 2, 0, 60
300, Flight69, 3, 54, 15, 8, 2, 3, 85
300, Flight70, 2, 40, 17, 3, 2, 4, 68
300, Flight71, 4, 54, 20, 4, 1, 2, 85
300, Flight72, 4, 37, 19, 14, 5, 4, 83
300, Flight73, 1, 14, 8, 1, 1, 1, 26
300, Flight74, 1, 63, 14, 3, 4, 3, 88
300, Flight75, 5, 35, 21, 8, 1, 3, 73
300, Flight76, 3, 45, 21, 3, 3, 2, 77
300, Flight77, 2, 41, 10, 3, 2, 2, 60
300, Flight78, 4, 62, 22, 4, 0, 1, 93
300, Flight79, 2, 26, 12, 2, 1, 1, 44
300, Flight80, 1, 70, 23, 14, 1, 1, 110
300, Flight81, 2, 96, 22, 10, 2, 1, 133
300, Flight82, 5, 57, 27, 9, 1, 3, 102
300, Flight83, 3, 34, 13, 9, 3, 2, 64
300, Flight84, 1, 13, 6, 2, 1, 1, 24
300, Flight85, 2, 60, 14, 9, 3, 4, 92
300, Flight86, 1, 63, 22, 6, 2, 2, 96
300, Flight87, 1, 57, 21, 13, 7, 5, 104
300, Flight88, 2, 70, 20, 5, 4, 2, 103
300, Flight89, 1, 78, 23, 6, 5, 1, 114
300, Flight90, 3, 72, 19, 4, 1, 3, 102
360, Flight61, 1, 8, 5, 3, 1, 0, 18
360, Flight63, 0, 1, 0, 0, 0, 0, 1
360, Flight64, 0, 9, 7, 3, 2, 1, 22
360, Flight65, 0, 5, 1, 0, 0, 0, 6
360, Flight66, 0, 9, 3, 2, 0, 0, 14
360, Flight67, 0, 8, 7, 2, 1, 0, 18
360, Flight68, 0, 2, 1, 0, 0, 0, 3
360, Flight69, 0, 1, 0, 0, 0, 0, 1
360, Flight70, 0, 1, 0, 0, 0, 0, 1
360, Flight71, 0, 4, 2, 0, 0, 0, 6
360, Flight72, 2, 6, 5, 3, 1, 2, 19
360, Flight74, 0, 3, 1, 0, 0, 0, 4
360, Flight75, 0, 2, 0, 0, 0, 0, 2
360, Flight76, 1, 6, 3, 1, 0, 0, 11
360, Flight77, 0, 1, 0, 0, 0, 0, 1
360, Flight78, 0, 4, 1, 0, 0, 0, 5
360, Flight80, 0, 7, 2, 1, 0, 0, 10
360, Flight81, 0, 16, 3, 2, 0, 0, 21
360, Flight82, 0, 3, 1, 0, 0, 0, 4
360, Flight83, 0, 2, 0, 0, 0, 0, 2
360, Flight85, 0, 3, 0, 0, 0, 0, 3
360, Flight86, 0, 4, 2, 0, 0, 0, 6
360, Flight87, 0, 8, 2, 1, 0, 1, 12
360, Flight88, 0, 5, 1, 0, 0, 0, 6
360, Flight89, 0, 8, 2, 1, 0, 0, 11
360, Flight90, 0, 8, 3, 1, 0, 0, 12